DIXY-78061	office
ABRIKOS I SUKHOFRUKTY	food
FINIK I OREKHI	food
PEREKRESTOK	food
MAGNIT	food
IP GULIEVA A.S.	food
VKUSVILL	food
RIOMAG	food
PRISMA	food
KRASNOE BELOE	food
ZOOMAGAZIN CHETYRE LAP	food
ZOOMAGAZIN	food
SAMOKAT	food
OOO RYBOLOV PROFI	food
ZOLOTAYA RYBKA	food
DIXY-	food
SHOKODEL	food
LYUDI LYUBYAT	food
PEKARNYA BULKA KHLEBA	food
ULYBKA RADUGI	food
DOMRU	home
APPLE.COM	home
FONDKAPREMONT	home
PETROELEKTROSBYT	home
PSCB   *SHUVALOV90_1	home
CITIBANK ALERTING SERVICE	home
PAY.MTS.RU	home
PETROMEDLAB	health
MEDI	health
APTEKA 312	health
APTEKA	health
OOO MEDEKSPRESS-SERVIS	health
DO DO	cafe
DODOPIZZA.RU	cafe
KFC	cafe
PEKARNYA CEKH85	cafe
BUSHE	cafe
TEREMOK	cafe
BURGER KING	cafe
PEKARNYA ULITKA	cafe
SUSHIWOK.RU	cafe
GORODSKIE KONDITERSKIE	cafe
CAFFE ITALIA	restaurant
MEALTY	office
METRO.SPB.RU	transport
PASSAZHIRAVTOTRANS	transport
UBER	transport
CITYMOBIL	transport
MOYA SEMEYNAYA SHKOLA	school
POLIKLINIKA N114	school
OOO GRAND	school
FAMILIA	goods
OSTIN	goods
WB	goods
WWW.ALIEXPRESS.COM	goods
KHOFF	goods
DECATHLON	goods
KUCHENLAND	goods
LEONARDO	goods
LOCCITANE	goods
2417 DETSKIY MIR	goods
PILKINAIL.RU	beauty
